%%%%%%%%%%%%%%%%%%%%%%%%%%%%%%%%%%%%%%%%%%%%%%%%%%%%%%%%%%%%%%%%%%%%%%%%%%%%%%%%%%%%%%%%%%%%%%%%%%%%%%%%%%%
%       % % %           %   %     % %       %   %   %         %         %   %   %           %     %   %   %
% %%%%%%% % %%% % %%% %%% %%%%%%% % %%%%% %%% % % %%% %%%%%%% %%% %%%%%%% % % % % %%%%%%%% %%% %%%%% %%% %%
%       %       % %     %     % %       %   % %     %       %   %   %     % %   %         %   %     %     %
%%%%% %%%%% %%% % % % %%% %%%%% % %%% %%% % % %%% %%% %%%%% %%% %%% % % %%% %%%%%%%% %%%%%%%%% %%% %%% %%%%
%   % % % %   % % % %   % %   % %   %   % % %     %     % %   %   % % %   % %   %       %   %   % %   % % %
% %%% % % % %%% %%%%% %%% % %%% % %%%%% % %%%%% %%%%%%% % %%% %%%%% % % % % % %%% %%%%% % % % %%% % % %%% %
%       %     %   %   %     % % %     % %       %       %   %       % %     % %   %     % %   %   %       %
%%% %%%%%%%%% %%%%%%% %%% %%% % % %%%%% % %%%%%%% %%%%%%%%% % %%%%%%% %%%%% % % %%% %%% % %%%%% % %%%%%%% %
%             %       % %   %     %     %   %     %       %   %   %         %   % %   %       %     %   % %
% % %%%%% % %%% % % %%% % %%% % % % %%%%% % % %%% % %%% %%% % %%% %%% %%% %%%%% %%% %%%%% %%%%%%% %%% %%% %
% % %     % % % % %     %   % % % % %     % % %   %   %   % %   %       %       %   %   % %     % %   %   %
% % % %%%%%%% % %%%%%%%%% %%% % % % % %%% %%% % %%% %%% %%% % %%%%% %%%%% %%%%% %%%%%%% % % %%%%%%% %%%%% %
% % % %     %   %     %     %   %   % %       %   %   % %     %     %       %   %     %       %         % %
%%% %%% % %%%%% %%%%% %%% %%% % % % % % %%%%% %%% %%% % %%% %%% % %%% %%%%% %%% % %%%%% %%%%%%% %%%%%%% % %
%     % % %     % %     % %   % %   % % %     % %   %     %   %   % %   %     %   %     %     %       %   %
% % % % % %%% %%% %%% %%% % %%% %%%%% % % % %%% %%% %%% %%%%%%% % %%% %%% %%%%% %%%%% %%%%% %%%%%%% %%%%% %
% % % % %                 % % %     %     %   %   %     %       %     %   %   % %   %     %       %       %
%%% %%%%%%% % % %%%%% %%% % % % %%% % %%% %%% %%% % %%% % % %%%%%%% %%%%% % %%% % % % %%% %%% % %%%%%%%% %%
%       % % % %     %   %     %   %     %   %   %   % % %   %         %     %     %   %   %   %         % %
%%%%% % % %%%%%%%%% %%%%%%%%%%% %%% % %%%%%%% % %%% %%% % %%% % %%%%%%% %%%%% %%%%% %%%%%%% %%% %%%%%%%%% %
%   % %           % %     %   % %   %     % %   %   %   % %   % %   %     %     %     % %   %       %     %
% %%% %%%%% %%%%%%%%% %%%%% % % %%% % %%% % %%% %%% %%% %%%%% % % %%% % %%% %%%%% %%% % %%% % % %%% % %%%%%
% %   %      %        %     %       %     %   %       %   % %     %     %       %   %   %   % %   %   %   %
% % % %%%%% %%% % % % % %%%%%%%%%%%%% %%%%%%%%% %%%%% %%% % %%%%%%% %%%%% %%%%%%% %%%%% %%% %%% %%%%% %%%%%
% % %   %     % % % %       %   % %   %       % % %   %   %       %   %   %     %   %     %       %   %   %
% % %%% %%% % % % %%%%%%%%% %%% % % %%% %%% %%% % % %%% %%% % % %%% %%% %%% %%% %%% %%% %%% %%% % %%% %%%%%
% %   % %   % % %   % %   % % %     %   %   %   %   %       % %       %   %   %     %   %       %   %   % %
% %%% %%% %%%%% %%% % % %%%%% %%%%%%% % % % %%%   %%% %%%%%%%%% %%%%%%%%% %%%%%%%%% % %%% %%%%%%%%% %%%%% %
%       %   %     % %     %   %     % % % %       %       %   %       %     %     %       %   %         % %
%%% % %%%%% %%%%% %%% %%% % %%% %%%%% % % % %%%%% %%%%%%% % % %%%%% %%%%%%%%%%%%% %%%%% %%% % %%% %%%%% % %
% % % % % % % %     % %   % %   % %   %   %   %     %     %       %   %         %     %   %   %   %     % %
% % %%% % % % % %%%%%%%%% % % % % % %%% %%% % % %%%%% % %%% % %%%%%%% % %%%%%%%% %%%%%%%%%%%%% %%% %%% % %%
%   %   %   %                 %  %  %     %     %   %       %       %           %                 %       %
% % % % %%% %%% %%%%%%% %%% %%% %%% %%% % %% %% % %%%%% %%% % % % %%%%% %%%%%%% %%% %%%%%%%%%%%%%%% %%%%% %
%.% % %               %        %            %    %                                             %        %P%
%%%%%%%%%%%%%%%%%%%%%%%%%%%%%%%%%%%%%%%%%%%%%%%%%%%%%%%%%%%%%%%%%%%%%%%%%%%%%%%%%%%%%%%%%%%%%%%%%%%%%%%%%%%
