%%%%%%%%%%%%%%%%%%%%%%%%%%%%%%%%%%%%%%%%%%%%%%%%%%%%%%%%%%%%%%%%%%%%%%%%%%%%%%%%%
%       % % %           %   %     % %       %   %   %         %         %   %   %
% %%%%%%% % %%% % %%% %%% %%%%%%% % %%%%% %%% % % %%% %%%%%%% %%% %%%%%%% % % % %
%       %       % %     %     % %       %   % %     %       %   %   %     % %   %
%%%%% %%%%% %%% % % % %%% %%%%% % %%% %%% % % %%% %%% %%%%% %%% %%% % % %%% %%%%%
%   % % % %   % % % %   % %   % %   %   % % %     %     % %   %   % % %   % %   %
% %%% % % % %%% %%%%% %%% % %%% % %%%%% % %%%%% %%%%%%% % %%% %%%%% % % % % % % %
%       %     %   %   %     % % %     % %       %       %   %       % %     % % %
%%% %%%%%%%%% %%%%%%% %%% %%% % % %%%%% % %%%%%%% %%%%%%%%% % %%%%%%% %%%%% % % %
%             %       % %   %     %     %   %     %       %   %   %         %   %
% % %%%%% % %%% % % %%% % %%% % % % %%%%% % % %%% % %%% %%% % %%% %%% %%% %%%%% %
% % %     % % % % %     %   % % % % %     % % %   %   %   % %   %       %       %
% % % %%%%%%% % %%%%%%%%% %%% % % % % %%% %%% % %%% %%% %%% % %%%%% %%%%% %%%%% %
% % % %     %   %     %     %   %   % %       %   %   % %     %     %       %   %
%%% %%% % %%%%% %%%%% %%% %%% % % % % % %%%%% %%% %%% % %%% %%% % %%% %%%%% %%% %
%     % % %     % %     % %   % %   % % %     % %   %     %   %   % %   %     % %
% % % % % %%% %%% %%% %%% % %%% %%%%% % % % %%% %%% %%% %%%%%%% % %%% %%% %%% % %
% % % % %                 % % %     %     %   %   %     %       %     %   % %   %
%%% %%%%%%% % % %%%%% %%% % % % %%% % %%% %%% %%% % %%% % % %%%%%%% %%%%% % % % %
%       % % % %     %   %     %   %     %   %   %   % % %   %         %     %   %
%%%%% % % %%%%%%%%% %%%%%%%%%%% %%% % %%%%%%% % %%% %%% % %%% % %%%%%%% %%%%% %%%
%   % %           % %     %   % %   %     % %   %   %   % %   % %   %     % %   %
% %%% %%%%% %%%%%%%%% %%%%% % % %%% % %%% % %%% %%% %%% %%%%% % % %%% % %%% % % %
% %   %      %        %     %       %     %   %       %   % %     %     % % %   %
% % % %%%%% %%% % % % % %%%%%%%%%%%%% %%%%%%%%% %%%%% %%% % %%%%%%% %%%%% % % % %
% % %   %     % % % %       %   % %   %       % % %   %   %       %   %   % % % %
% % %%% %%% % % % %%%%%%%%% %%% % % %%% %%% %%% % % %%% %%% % % %%% %%% %%% % % %
% %   % %   % % %   % %   % % %     %   %   %   %   %       % %       %   %   % %
% %%% %%% %%%%% %%% % % %%%%% %%%%%%% % % % %%%%%%%%% %%%%%%%%% %%%%%%%%% %%%%% %
%       %   %     % %     %   %     % % % %       %       %   %       %     %   %
%%% % %%%%% %%%%% %%% %%% % %%% %%%%% % % % %%%%% %%%%%%% % % %%%%% %%%%%%%%% % %
% % % % % % % %     % %   % %   % %   %   %   %     %     %       %   %         %
% % %%% % % % % %%%%%%%%% % % % % % %%% %%% % % %%%%% % %%% % %%%%%%% % %%%%%%% %
%   %   %   %                 %     %     %     %   %       %       %           %
% % % % %%% %%% %%%%%%% %%% %%% %%% %%% % %%%%% % %%%%% %%% % % % %%%%% %%%%%%% %
%.% % %       %   %       %   % %   %   %     %   %     % %   %     %          P%
%%%%%%%%%%%%%%%%%%%%%%%%%%%%%%%%%%%%%%%%%%%%%%%%%%%%%%%%%%%%%%%%%%%%%%%%%%%%%%%%%
